运行程序			运行命令

辅助功能选项		access.cpl
添加硬件向导		hdwwiz.cpl
添加或删除程序		appwiz.cpl
管理工具			control admintools
自动更新			wuaucpl.cpl
Bluetooth文件传送向导	fsquirt
计算器			calc
证书管理控制台		certmgr.msc
字符映射表		charmap
磁盘检查工具		chkdsk
剪贴簿查看器		clipbrd
命令行提示符		cmd
组件服务			dcomcnfg
计算机管理		compmgmt.msc
日期和时间属性		timedate.cpl
DDE共享			ddeshare
设备管理器		devmgmt.msc
Direct X控制面板(如果已经安装)*	directx.cpl
Direct X诊断工具		dxdiag
磁盘清理工具		cleanmgr
磁盘碎片整理程序		dfrg.msc
磁盘管理			diskmgmt.msc
磁盘分区管理器		diskpart
显示属性			control desktop
显示属性			desk.cpl
显示属性的外观选项卡	control color
Dr. Watson系统诊断工具	drwtsn32
Driver Verifier Manager	verifier
事件查看器		eventvwr.msc
文件签名验证		sigverif
快速查找			findfast.cpl
文件夹选项		control folders
字体文件夹		control fonts
字体文件夹		fonts
空档接龙游戏		freecell
游戏控制			joy.cpl
组策略编辑器(XP专业版)	gpedit.msc
红心大战游戏		mshearts
Iexpress向导		iexpress
索引服务			ciadv.msc
Internet属性		inetcpl.cpl
IP配置实用程序(显示连接配置)	ipconfig /all
IP配置实用程序(显示DNS缓存内容)	ipconfig /displaydns
IP配置实用程序(删除DNS缓存内容)	ipconfig /flushdns
IP配置实用程序(释放全部(或指定)适配器的由DHCP分配的动 态IP地址)	ipconfig /release
IP配置实用程序(为全部适配器重新分配IP地址)	ipconfig /renew
IP配置实用程序(刷新DHCP并重新注册DNS)	ipconfig /registerdns
IP配置实用程序(显示DHCP Class ID)	ipconfig /showclassid
IP配置实用程序(修改DHCP Class ID)	ipconfig /setclassid
Java控制面板(如果已经安装)	jpicpl32.cpl
Java控制面板(如果已经安装)	javaws
键盘属性			control keyboard
本地安全设置		secpol.msc
本地用户和组		lusrmgr.msc
从Windows注销		logoff
微软聊天程序		winchat
扫雷游戏			winmine
鼠标属性			control mouse
鼠标属性			main.cpl
网络连接			control netconnections
网络连接			ncpa.cpl
网络安装向导		netsetup.cpl
记事本			notepad
Nview桌面管理器(如果已经安装)	nvtuicpl.cpl
对象包装程序		packager
ODBC数据源管理器		odbccp32.cpl
屏幕键盘			osk
AC3解码器(如果已经安装)	ac3filter.cpl
密码属性			password.cpl
性能			perfmon.msc
性能			perfmon
电话与调制解调器选项	telephon.cpl
电源选项属性		powercfg.cpl
打印机和传真		control printers
打印机文件夹		printers
TrueType造字程序		eudcedit
Quicktime(如果已经安装)	QuickTime.cpl
区域和语言选项		intl.cpl
注册表编辑器		regedit
注册表编辑器		regedit32
远程桌面			mstsc
可移动存储		ntmsmgr.msc
可移动存储操作请求		ntmsoprq.msc
策略的结果集 (XP专业版)	rsop.msc
扫描仪与相机		sticpl.cpl
任务计划			control schedtasks
Windows安全中心		wscui.cpl
服务			services.msc
共享文件夹		fsmgmt.msc
关闭Windows		shutdown
声音和音频设备属性		mmsys.cpl
蜘蛛牌游戏		spider
SQL Client客户端网络实用工具	cliconfg
系统配置编辑器		sysedit
系统配置实用程序		msconfig
系统文件检查工具(立即扫描)	sfc /scannow
系统文件检查工具(下次启动时扫描)	sfc /scanonce
系统文件检查工具(每次启动时扫描)	sfc /scanboot
系统文件检查工具(返回默认设置)	sfc /revert
系统文件检查工具(清除文件缓存)	sfc /purgecache
系统文件检查工具(设置缓存=x)	sfc /cachesize=x
系统属性			sysdm.cpl
任务管理器		taskmgr
Telnet客户端		telnet
用户帐户管理		nusrmgr.cpl
辅助工具管理器		utilman
Windows防火墙		firewall.cpl
Windows放大镜		magnify
Windows管理体系结构	wmimgmt.msc
Windows系统安全工具	syskey
运行Windows更新		wupdmgr
漫游Windows XP		tourstart
写字板			write